............
.0..........
............
#X3X3X3X.#3X
......X#....
.3.3.X.#....
..X.#3..#...
..#.X..G#...
......#3X...
......#.3...
........X...
............